.X.XX......X.A.
..X......X.....
...XXX.X....XXX
X....X..XX...XX
.XX.....X..X...
..X..X.X.X.....
X...........X.X
.XX..X..X..X...
...XBX..X......
X....XXX.XX....
