............X.......................A.X.
...................................X....
.......X.X........X......X.X..........X.
......................................XX
....X...................................
..X........X......................X.....
...............X........................
...............X........................
.................................X......
...................X.X...X........X.....
......X.................................
...X....X...............................
.................................X......
........................................
........X.X.....................X.......
.........................B..............
..X....X.....X........................X.
........X.....X.........................
.............................X..X.......
.................X......................
